############################
#*...........##............#
#.####.#####.##.#####.####.#
#.####.#####.##.#####.####*#
#.####.#####.##.#####.####.#
#..........................#
#.####.##.########.##.####.#
#.####.##.########.##.####.#
#......##....##....##......#
######.#####_##_#####.######
######.#####_##_#####.######
######*##____&_____##.######
######.##_###+####_##.######
######.##_###_####_##.######
______.___###$####___.______
######.##_###%####_##.######
######.##_########_##.######
######.##__________##.######
######.##_########_##.######
######.##_########_##.######
#............##............#
#.####.#####.##*#####.####.#
#.####.#####.##.#####.####.#
#...##.......@........##...#
###.##.##.########.##.##.###
###.##.##.########.##.##.###
#......##....##....##......#
#.##########.##.##########.#
#.##########.##.##########.#
#............*.............#
############################
############################